{
	"mapWidth": 20,
	"mapHeight": 20,
	"tileWidth": 95,
	"tileHeight": 48,
	"tileset": [
		{ "id": 0, "tileName": "plains", "texFileName": "assets/textures/default_map/plains.png", "tileRising": 0 },
		{ "id": 1, "tileName": "hills", "texFileName": "assets/textures/default_map/hills.png", "tileRising": 9 },
		{ "id": 2, "tileName": "forest", "texFileName": "assets/textures/default_map/forest.png", "tileRising": 8 },
		{ "id": 3, "tileName": "mountains", "texFileName": "assets/textures/default_map/mountains.png", "tileRising": 9 },
		{ "id": 4, "tileName": "lake", "texFileName": "assets/textures/default_map/lake.png", "tileRising": 0 },
		{ "id": 5, "tileName": "ocean", "texFileName": "assets/textures/default_map/ocean.png", "tileRising": 0 },
		{ "id": 6, "tileName": "camp", "texFileName": "assets/textures/building_base_camp_1.png", "tileRising": 0 },
		{ "id": 7, "tileName": "woodcutter", "texFileName": "assets/textures/building_woodcutter_1.png", "tileRising": 3 }
	],
	"terrain_layer": [
		3, 3, 2, 2, 2, 2, 2, 2, 2, 2, 2, 2, 2, 2, 2, 2, 2, 2, 2, 0,
		3, 1, 2, 2, 2, 2, 2, 2, 2, 2, 2, 2, 2, 2, 2, 2, 0, 0, 0, 0,
		2, 2, 2, 2, 2, 2, 2, 2, 2, 0, 0, 0, 0, 0, 0, 0, 0, 0, 0, 0,
		2, 2, 2, 2, 0, 0, 0, 0, 0, 0, 0, 0, 0, 0, 0, 0, 0, 0, 0, 0,
		2, 2, 0, 0, 0, 0, 0, 0, 0, 0, 0, 0, 0, 0, 0, 0, 0, 0, 0, 0,
		2, 0, 0, 0, 0, 0, 0, 0, 0, 0, 0, 0, 0, 0, 0, 0, 0, 0, 0, 0,
		0, 0, 0, 0, 0, 0, 2, 0, 0, 0, 0, 0, 2, 0, 0, 0, 0, 0, 0, 0,
		0, 0, 0, 0, 0, 0, 2, 2, 0, 0, 0, 0, 0, 0, 0, 2, 2, 0, 0, 0,
		0, 0, 0, 0, 0, 2, 2, 2, 4, 2, 0, 0, 0, 0, 0, 0, 2, 0, 0, 0,
		0, 0, 0, 0, 2, 2, 2, 2, 2, 7, 6, 0, 0, 0, 0, 0, 0, 0, 0, 0,
		2, 0, 0, 0, 0, 0, 0, 0, 0, 0, 0, 0, 0, 0, 0, 0, 0, 0, 0, 0,
		2, 1, 1, 0, 0, 0, 0, 0, 0, 0, 0, 0, 0, 0, 0, 0, 0, 0, 0, 0,
		3, 1, 1, 1, 1, 0, 0, 0, 0, 0, 0, 0, 0, 0, 2, 0, 0, 0, 0, 0,
		3, 3, 3, 1, 1, 1, 0, 0, 0, 2, 0, 0, 0, 2, 2, 0, 0, 0, 0, 0,
		3, 3, 3, 2, 2, 1, 0, 0, 0, 0, 0, 0, 0, 0, 0, 0, 0, 0, 0, 0,
		3, 3, 2, 0, 0, 0, 0, 0, 0, 0, 0, 0, 0, 0, 0, 0, 0, 0, 0, 5,
		3, 3, 2, 0, 0, 0, 0, 0, 0, 0, 0, 0, 0, 0, 2, 0, 0, 0, 0, 5,
		3, 1, 0, 0, 0, 0, 0, 0, 0, 2, 2, 0, 0, 0, 2, 2, 0, 0, 5, 5,
		3, 1, 0, 0, 0, 0, 0, 0, 0, 2, 0, 0, 0, 0, 0, 0, 0, 0, 5, 5,
		3, 2, 0, 0, 0, 0, 0, 0, 0, 0, 0, 0, 0, 0, 0, 0, 0, 5, 5, 5
	],
	"wares_layer": [
		0, 0, 5, 5, 5, 5, 5, 5, 5, 5, 5, 5, 5, 5, 5, 5, 5, 5, 5, 4,
		0, 0, 5, 5, 5, 5, 5, 5, 5, 5, 5, 5, 5, 5, 5, 5, 4, 4, 4, 4,
		5, 5, 5, 5, 5, 5, 5, 5, 5, 4, 4, 4, 4, 4, 4, 4, 4, 4, 4, 4,
		5, 5, 5, 5, 4, 4, 4, 4, 4, 4, 4, 4, 4, 4, 4, 4, 4, 4, 4, 4,
		5, 5, 4, 4, 4, 4, 4, 4, 4, 4, 4, 4, 4, 4, 4, 4, 4, 4, 4, 4,
		5, 4, 4, 4, 4, 4, 4, 4, 4, 4, 4, 4, 4, 4, 4, 4, 4, 4, 4, 4,
		4, 4, 4, 4, 4, 4, 5, 4, 4, 4, 4, 4, 5, 4, 4, 4, 4, 4, 4, 4,
		4, 4, 4, 4, 4, 4, 5, 5, 4, 4, 4, 4, 4, 4, 4, 5, 5, 4, 4, 4,
		4, 4, 4, 4, 4, 5, 5, 5, 2, 4, 4, 4, 4, 4, 4, 4, 5, 4, 4, 4,
		4, 4, 4, 4, 5, 5, 5, 5, 5, 4, 4, 4, 4, 4, 4, 4, 4, 4, 4, 4,
		5, 4, 4, 4, 4, 4, 4, 4, 4, 4, 4, 4, 4, 4, 4, 4, 4, 4, 4, 4,
		5, 0, 0, 4, 4, 4, 4, 4, 4, 4, 4, 4, 4, 4, 4, 4, 4, 4, 4, 4,
		0, 0, 0, 0, 0, 4, 4, 4, 4, 4, 4, 4, 4, 4, 5, 4, 4, 4, 4, 4,
		0, 0, 0, 0, 0, 0, 4, 4, 4, 5, 4, 4, 4, 5, 5, 4, 4, 4, 4, 4,
		0, 0, 0, 5, 5, 0, 4, 4, 4, 4, 4, 4, 4, 4, 4, 4, 4, 4, 4, 4,
		0, 0, 5, 4, 4, 4, 4, 4, 4, 4, 4, 4, 4, 4, 4, 4, 4, 4, 4, 515,
		0, 0, 5, 4, 4, 4, 4, 4, 4, 4, 4, 4, 4, 4, 5, 4, 4, 4, 4, 515,
		0, 0, 4, 4, 4, 4, 4, 4, 4, 5, 5, 4, 4, 4, 5, 5, 4, 4, 515, 515,
		0, 0, 4, 4, 4, 4, 4, 4, 4, 5, 4, 4, 4, 4, 4, 4, 4, 4, 515, 3,
		0, 5, 4, 4, 4, 4, 4, 4, 4, 4, 4, 4, 4, 4, 4, 4, 4, 515, 515, 3
	]
}
